Q.20   What are logical and physical tags in HTML?

Physical and Logical tags are used in HTML for better visibility and understanding of the text by the user on the web page. However, both tags differ from each other as suggested by their names.

Logical Tags  :
Logical Tags are used in HTML to display the text according to the logical styles. Following are the Logical tags commonly used in HTML.

Logical Tags Example=

Tag	Description
<abbr>	Defines an abbreviation
<acronym>	Defines an acronym
<address>	Defines an address element
<cite>	Defines citation
<code>	Defines computer code text
<blockquote>	Defines a long quotation
<del>	Defines text
<dfn>	Defines a definition term
<ins>	Defines inserted text
<kbd>	Defines keyboard text
<pre>	Defines preformatted text
<q>	Defines short quotation
<samp>	Defines sample computer code
<strong>	Defines strong text
<var>	Defines a variable

Physical Tags 

Physical Tags are used in HTML to provide actual physical formatting to the text. Following are the Physical tags commonly used in HTML.

Physical Tags Example=

Tag	Description
<b>	Defines bold text
<big>	Defines big text
<i>	Defines italic text
<small>	Defines small text
<sup>	Defines superscripted text
<sub>	Defines subscripted text
<tt>	Defines teletype text
<u>	Deprecated. Use styles instead